abandon	(v., 抛弃，遗弃；（因危险）离开，舍弃；中止，不再有；放弃（信念、信仰或看法）；陷入，沉湎于（某种情感）), (n., 放任，放纵)
accommodate	(v., 为……提供住宿；容纳，提供空间；考虑到，顾及；顺应，适应；帮助（某人），向……施以援手；迎合，迁就；调解)
academy	(n., 专科院校；研究院，学会；（美国的）私立学校；（苏格兰的）中等学校)
access	(n., 入口，通道；获得的机会，使用权；（对计算机存储器的）访问，存取；（情感）爆发，发作；探视权), (v., 接近，进入；获取，访问（计算机信息）), (adj., <美>（电视节目或时间等）对外公开的)
accompany	(v., 陪伴，陪同；伴随，与……一起发生；为……伴奏（或伴唱）；附带，补充)
accumulate	(v., 积累，积攒)
abstract	(adj., 抽象的，纯概念的；（艺术）抽象派的；理论上的，不切实际的), (n., 摘要，梗概；抽象画，抽象派艺术作品；抽象的概念), (v., 抽象化，从理论上（或孤立地）考虑；提取，使分离；写……的摘要；偷走，窃取；退出)
accurate	(adj., 准确的，精确的；（工具，方法）精密的；正确无误的；（武器、投掷）精准的)
acknowledge	(v., 承认；认可； 跟……打招呼，理会；告知收到；（公开）感谢)
adequate	(adj., 足够的，适当的，合乎需要的；（品质）足够好的，令人满意的；（质量）达到要求的，勉强过关的)
acquire	(v., 获得，得到；学到，习得；患上（疾病）；逐渐具有，开始学会)
adapt	(v., 适应；调整，使适合；改编；改造，改装)
achieve	(v., （经努力）达到，取得，实现；获得成功)
adjacent	(adj., 邻近的，毗连的；（几何）（两个角）相邻的)
adjust	(v., 调整，调节；整理（衣服）；适应，习惯；（保险理赔时）理算，评估（损失，损害）)
advocate	(v., 拥护，提倡), (n., 拥护者，提倡者；辩护律师；（为某一类人）谋利益者；（一项事业或个组织的）工作者)
aggregate	(n., 总数，合计；骨料，混凝料), (adj., 总计的，合计的；（种群）聚生的), (v., 集合，聚集；总计达到；合计)
affect	(v., 影响；（疾病）侵袭，感染；（在感情上）深深打动，震撼；<正式> 假装，佯装), (n., （尤指影响行为或行动的）情感，感情)
administrate	(v., 管理，经营)
adult	(n., 成年人；成年动物), (adj., 成年的，发育成熟的；成人的，理智的；（电影、杂志等）仅限于成人的), (v., <非正式>像成年人一样表现；<非正式>变成熟)
allocate	(v., 分配，分派，划拨)
alternative	(n., 可供选择的事物，替代物), (adj., 可替代的，备选的；非传统的，另类的；（两者）互不相容的，非此即彼的)
aid	(n., 帮助；援助，救助；辅助物，辅助设施；助手；特别津贴，国库税), (v., 帮助，援助；促进，有助于)
ambiguous	(adj., 模棱两可的，有歧义的；不明朗的，不确定的)
alter	(v., 改变，改动；（使）变化；改（服装）；改建（某建筑）；<美>阉割)
albeit	(conj., 虽然，尽管)
amend	(v., 修改，修订；纠正，改正；改善（土壤）的结构（或肥力）；<古>修复；改过自新)
analyse	(v., 分析，细察；分解，化验；对……进行心理分析)
append	(v., <正式>附加，增补)
analogy	(n., 类比，比拟；用类比方法，进行比照；同功)
appropriate	(adj., 合适的，相称的), (v., 拨出（款项）；私占，挪用)
approach	(v., 靠近，临近；接洽，交谈；对付，处理；近似，接近于), (n., 方法，态度；靠近，接近；接洽，要求；通道，路径；进场着陆；近似物)
apparent	(adj., 显而易见的，易懂的；貌似的，表面上的)
anticipate	(v., 预期，预料；预见（并做准备）；期望，盼望；先于……做，早于……行动；提前使用；在期限内履行（义务），偿还（债务）)
arbitrary	(adj., 任意的，随心所欲的；专横的，武断的)
approximate	(adj., 大概的，近似的), (v., 类似，接近；模仿，模拟；粗略估计)
annual	(adj., 一年一度的；年度的；（植物）一年生的), (n., 一年生植物；年刊，年鉴)
appreciate	(v., 欣赏，鉴赏；理解，明白；感谢，感激；升值，增值)
area	(n., 地区，区域；场地，地方；领域；面积；部位；罚球区)
aspect	(n., 方面，特色；朝向，方位；外表，外观；（动词的）体), (v., （行星与另一天体）形成角度关系)
assemble	(v., （使）集合，（使）聚集；装配，组装)
assess	(v., 评价，评定；估价，估计；征税，处以罚金)
assign	(v., 分派，布置（工作、任务）；分配（某物）；指派，派遣；确定（价值、功能、时间、地点）；转让（财产、权利）)
assume	(v., 假定，假设，认为；装出，做出；承担，就职；呈现，具有；夺取，篡夺)
assure	(v., 使确信，向……保证；确保，使确定；给……保险)
assist	(v., 帮助，协助；<古>参加，出席), (n., （球赛中的）助攻；资助，帮助)
attain	(v., 获得，实现；达到)
attribute	(v., 把……归因于；认为是……所作；认为……具有某种特质), (n., 属性，特质；标志，象征；定语)
attach	(v., 系上，贴上，连接；附上（附件）；赋予，认为……具有； 和……在一起，缠着； 附带（条件)；附属，依附；与……有关联；委派；扣押（债务人或其财产)；使依恋)
attitude	(n., 态度，看法；姿势；个人风格；<非正式>敌视的态度；（飞机或宇宙飞船飞行时的）姿态；（芭蕾）鹤立式)
aware	(adj., 知道的，明白的；察觉到的，意识到的；有……意识的，有……知识的)
authority	(n., 专家，权威人士；行政管理机构；权利，权限；权威，威信；许可，授权；当局，官方)
author	(n., 作者，著者；作家；发起者，创始人；作品), (v., 撰写，写作；发起，创造)
available	(adj., 可用的，可获得的；有空的，有闲暇的；未婚的，单身的)
behalf	(n., 代表（on behalf of）；因为，为了……的利益（in/on behalf of）；就……而言，在……一方（on behalf of）)
automate	(v., 使自动化)
benefit	(n., 好处，益处；救济金，补助金；额外奖励，保险金；慈善活动), (v., 对（某人）有用，使受益；得益于，得利于)
brief	(adj., 短暂的；简短的；（衣服）很短的), (v., 给……指示，向……介绍情况；<英>向（辩护律师）提供案情摘要), (n., 指示，任务简介；摘要，概要；短内裤（briefs）；辩护状；辩护律师；<英>委托辩护)
bias	(n., 偏见，成见；偏好，天赋；倾向，趋势；斜纹；（统计）偏差，偏倚；偏重心球形；偏压，偏统), (v., 使有偏见，使偏心；加偏压（或偏流）于), (adj., 偏斜的), (adv., 偏斜地)
bond	(n., 纽带，联系；公债，债券；结合，黏合；承诺，契约；枷锁，桎梏), (v., （使）建立亲密关系；与……黏合（或连接）)
bulk	(n., 主体，大部分；庞大的身躯，肥硕的体形；（巨大的）容积，体积), (adj., 大批的，大宗的), (v., 使（产品）数量显得很大；结合（待售的股票或商品）)
capacity	(n., 能力，才能；容积，容纳能力；职位，职责；功率，容积；生产量，生产能力), (adj., 无虚席的，满场的)
channel	(n., 频道，电视频道；管道，通道，航道；渠道，手段；沟渠，沟槽；河床；海峡；信道；电子沟道；输液道), (v., 引导，把……用于；输送，传送；通灵；努力赶上，受启发；形成凹槽)
category	(n., 种类，范畴)
cease	(v., 终止，结束), (n., 停止)
capable	(adj., 有能力的；有本领的，能干的；可以……的，容许……的)
challenge	(n., 挑战，难题；挑战书，比赛邀请；质疑，质询；喝停盘查), (v., 挑战，向……下战书；质疑，拒绝接受；盘问，查问；考验)
chart	(n., 图表，曲线图；海图，星位图；排行榜), (v., 绘制；记录，跟踪；制定（行动计划）；进榜，上榜)
clarify	(v., 澄清，阐明；（通过加热）使净化，使纯净)
cite	(v., 引用，援引；引证，引以为例；传唤，传讯；嘉奖，表彰), (n., <美>引用，引文)
circumstance	(n., 条件，情况，环境；境况，经济状况；详情，原委；命运，境遇), (v., 处于某种情况)
civil	(adj., 公民的，国民的，国内的；平民的，民用的；文明的，有礼貌的；民法的（非刑法的），民事的；习俗规定的，历法规定的)
chapter	(n., 章，回，篇；阶段，时期；分会，分部；议会法案；一系列，一连串（a chapter of）；全体教士；宗教团体理事会), (v., 把……分成章节)
chemical	(adj., 化学的，与化学有关的), (n., 化学品，化学制品；成瘾的药物)
classic	(adj., 典型的，有代表性的；一流的，经典的；古朴的，典雅的；<非正式>糟糕的，讨厌的), (n., 经典作品，杰作；杰出的事物，典范；传统活动，传统项目)
clause	(n., 从句，分句；（法律文件的）条款)
coincide	(v., 巧合，同时发生；一致，相符；相交，重叠)
commence	(v., 开始，着手)
colleague	(n., 同事，同僚)
coherent	(adj., 有条理的，连贯的；说话条理清晰的，易于理解的；团结一致的，凝聚的；（波）相干的，相参的；黏着的，黏连的)
code	(n., 密码，暗码；（邮政）编码，（电话）区号；（计算机）编码；道德准则，行为规范；法典，法规), (v., 把……编码（或编号）；把……译成密码；（给计算机）编写指令)
collapse	(v., 倒塌，塌下；崩溃，瓦解；突然倒下，昏倒；瘫倒；突然贬值，暴跌；萎陷，瘪掉；折叠), (n., 倒塌，塌陷；突然失败，崩溃；病倒，垮掉；突然贬值，暴跌)
comment	(n., 评论，意见；批评，指责；说明，写照；<旧>解说，注释；（计算机）注解), (v., 评论，发表意见；（计算机）注解，把（部分程序）转成注解)
commission	(n., 考察团，委员会；佣金，回扣；犯罪；委托，命令；（军队中的）官职，军衔；（尤指艺术品）委托制作；<古>所授之权，代办权), (v., 委托撰写，委托制作；委任，任命……为军官；（使军舰）正式使用，服现役)
commit	(v., 犯（罪、错）；调拨，投入；（使）承诺，承担义务；郑重承诺，忠于；把……关进医院（监狱），监禁；传唤（某人）到法院受审；订婚，决定与（某人）保持长期感情；把……托付给)
compensate	(v., 赔偿，偿付；弥补，补偿；抵消；酬报（某人）)
compile	(v., 汇编，编纂；编译（电脑程式）；收集，搜集（信息，资料）；累积（得分）)
communicate	(v., 传递信息，通讯；传达，传递（想法或感情）；传染（疾病）；（房间或建筑）相通，相连；传输（热，力），传递（运动）；领受圣餐)
complement	(v., 补充，补足), (n., 补足物，衬托物；足数，足额；补语；余角；补体，防御素)
community	(n., 社区，社会；（由同国籍、同宗教等构成的）群体，界；（多个国家的）共同体；归属感；（动植物的）群落)
compatible	(adj., 兼容的；可共存的；可和睦相处的；与……一致的), (n., 兼容性计算机)
commodity	(n., 商品，货物；有用的东西，必需品)
complex	(adj., 复杂的，难懂的；组合的，合成的；（句子）复合的；复数的，复的；配合的，络合的), (n., 综合大楼，建筑群；复合体，综合体；情结；强烈（或过度）的关心（或忧虑）；配合物，络合物)
conceive	(v., 构思，设想；使受孕，怀孕)
comprise	(v., 包括，包含；构成，组成)
compute	(v., 估算，计算；<美，非正式>不合情理，讲不通；用计算机计算), (n., 计算，估计)
concentrate	(v., 集中注意力，聚精会神；使集中，聚集；浓缩), (n., 浓缩物，浓缩液)
compound	(n., 混合物，化合物；复合词；大院，有围墙的场地), (adj., 复合的，混合的；以复利计算的), (v., 使加重，使恶化；合成，混合；以复利计算支付；和解，私了)
component	(n., 组成部份，成分，部件), (adj., 组成的，构成的)
comprehensive	(adj., 综合性的，全面的；有理解力的), (n., 综合中学；专业综合测验)
concept	(n., 概念，观念), (adj., （围绕）某主题的；为表达一种想法而创造的), (v., <非正式>想象，设想)
concurrent	(adj., 并存的，同时发生的；同意的，一致的；（两个或两个以上徒刑判决）同时执行的；（三条或三条以上线）共点的，会合的), (n., 共点；同时发生的事件)
conflict	(n., 争执，争论，分歧；战斗，战争；抵触，矛盾), (v., 冲突，抵触)
confine	(v., 限制，局限；防止……扩散；关押，监禁；使离不开（或受困于床、轮椅等）), (n., 边界，范围；限制，局限)
conduct	(v., 实施，进行；指挥；带领，引导；举止，表现；传导), (n., 行为，举止；经营方式，管理方法)
confer	(v., 授予，赋予；商讨，交换意见)
conclude	(v., 断定，推断出；结束，终止；达成，做成，完成；<美>决定)
conform	(v., 遵守，符合；顺从，随潮流；一致，相吻合)
confirm	(v., 确定，确认；证实，证明；批准，认可；使坚定，加强；给（某人）施坚信礼)
consequent	(adj., 随之发生的，由此引起的；（河流，山谷）顺向的), (n., 后件，推断；（音乐）答题，答句)
consent	(n., 许可，允许；同意，赞同；正式批准文件，批文), (v., 赞同，准许，同意)
considerable	(adj., 相当大的，相当重要的；（人）显要的，值得尊敬的)
consist	(v., 由……组成，由……构成；在于，存在于)
constant	(adj., 持续不断的，经常发生的；恒定的，不变的；忠诚的，忠实的), (n., 常数，恒量；不变的事物)
constitute	(v., 组成，构成；是，被视为；成立，设立；任命)
consult	(v., 咨询，请教；商量，商讨；查询，查阅；当顾问)
consume	(v., 消耗，消费；吃，喝；吞噬，烧毁；使……着迷，充满)
constrain	(v., 限制，约束；强迫，迫使)
construct	(v., 建造，修建；组成，创立，构思；绘制，作图), (n., 构想，观念；建筑物，创造物；结构体)
contact	(n., 联系，联络；接触，触摸；联络人，熟人，社会关系；会见，往来，接触；传染病接触者；隐形眼镜；接通电，触点，接头；（无线电）通信), (v., 联系，联络；接触), (adj., 供联络的；接触性的，通过接触而起作用的)
contemporary	(adj., 当代的，现代的；同时期的，同时代的), (n., 同时代的人；同龄人，同辈)
context	(n., 背景，环境；上下文，语境)
contract	(n., 合同，契约；<非正式>暗杀协议；（桥牌）定约墩数；婚约，订婚), (v., （使）收缩，缩小；签合同，订立契约；患上，感染；订立婚约（或盟约）；欠负（债）)
contrary	(adj., 相反的，相对的；乖戾的，好与人作对的；逆向的，逆行的), (n., 相反的事实（或事情、情况）；对立命题，反对命题), (adv., 相反地)
contradict	(v., 反驳，否认；相抵触，相矛盾；发生矛盾)
convene	(v., 召集，集合，开会；传唤)
cooperate	(v., 合作，协作；配合，协助)
contrast	(n., 差异，对比；对照物，明显不同的事物；（摄影或绘画中的）颜色反差，明暗对比；（电视屏幕的）图像明暗对比度，反差), (v., 对比，对照；显出明显的差异，形成对比)
contribute	(v., 捐赠，捐助；（为……）做贡献；促成，是……的原因之一；撰稿，投稿；发表意见，提议)
convince	(v., 使确信，使信服；说服，劝服)
converse	(v., 谈话，交谈), (n., 相反的事物，反面说法；<旧>谈话，交谈；逆命题), (adj., 相反的，颠倒的，逆向的)
coordinate	(v., 协调，配合；使身体协调；（使颜色、款式、风格等）搭配，配套；给 （原子或分子）配位，与……形成共价键), (n., 坐标；配套服装；同等级（或类别）的人（或事物）), (adj., 地位相当的，同等重要的；（语法）并列的；（化学）配位的)
convert	(v., （使）转变，（使）转换；（使）改变信仰，（使）皈依；（达阵后）得附加分；使……迷上，使……热衷于), (n., 皈依宗教者，改变信仰者；刚迷上……的人，最近开始热衷于……的人)
controversy	(n., 争论，争议)
corporate	(adj., 公司的；法人的；共同的，全体的), (n., 公司，集团)
correspond	(v., 类似于，相当于；通信；相一致，符合)
core	(n., 果核；中心部分；核心，要点；骨干，核心成员；地核，天体的核心；核反应堆堆芯；芯体), (v., 给……去核), (adj., 核心的，最重要的；基础的，必修的)
couple	(n., 两个，几个；一对夫妇，一对情侣), (v., 加上，结合；（把设备等）连接；形成一双，配成一对；<旧>交配，交媾；（用电磁感应，静电荷或光学通信线路）将（电路元件）耦合)
create	(v., 创造，创建；设计，创作；造成，引起；授予，册封；<英，非正式>大惊小怪，抱怨)
culture	(n., 文化，文明；（团体或组织中共同的）态度，习俗；文化群落，（处于历史上特定时期的）社会；艺术活动；修养；（细胞、细菌等的）培养，培养物；栽培，养殖), (v., 培育，养殖)
currency	(n., 通货，货币；通用，流行；现时性)
credit	(n., 信用，信贷，赊购；赞扬，信誉，声望；存款金额，余额；补助；退税，抵免；学分；带来荣耀的人（或事）；作品（指影片、电视节目、戏剧等）；信任，相信), (v., 把（钱）记入总账，把钱存入（账户）；相信，信任；认为是……的功劳，给予承认；认为……有特定品质（或效果）)
data	(n., 数据，资料；（储存在计算机中的）数据资料)
debate	(n., 讨论，辩论), (v., 反复思考，斟酌；讨论，辩论)
cycle	(n., 自行车，摩托车；循环，周期；组诗，组歌；整套，系列；自行车骑行；一段时间), (v., 骑自行车；循环)
criteria	(n., （评判或做决定的）标准，准则，尺度 （criterion 的复数）)
crucial	(adj., 至关重要的，决定性的；<非正式>极好的)
decade	(n., 十年，十年期；十进)
deduce	(v., 推断，演绎；<古>对……追本溯源)
decline	(v., 下降，衰退；拒绝，谢绝；变格，词形变化), (n., 减少，衰退)
define	(v., 给……下定义，解释；阐明，使清楚；标明……界限，明确显出……轮廓；是……的特征，为……的特色)
definite	(adj., 清晰的，明晰的；确定的，不会改变的；肯定的，一定的), (n., 确定之事)
depress	(v., 使抑郁，使沮丧；降低，抑制；使萧条，使不景气；按下，压下)
despite	(prep., 尽管，即使；不由自主地，忍不住地), (n., <古>亵渎；<古>轻蔑，鄙视), (v., <古>蔑视；<古>激怒)
design	(n., 设计，布局，安排；设计艺术，构思；设计图，图纸；图案，花纹；计划，意图), (v., 设计，制图，构思；筹划，制订；预定，指定)
deny	(v., 否认；拒绝承认；拒绝给予)
denote	(v., 标志，预示；表示，意指)
demonstrate	(v., 证明；示范，演示；表露；游行，示威)
detect	(v., 查明，察觉；测出，检测，识别)
deviate	(v., 偏离，脱离；违背), (adj., 离经叛道的), (n., 异类，偏离规范的人；偏离)
device	(n., 装置，设备；手段，方法；花招，诡计；炸弹，爆炸装置；图画，设计；<古>（某物的）样式，外表)
devote	(v., 献身，致力；用于)
differentiate	(v., 使不同；求……的微分；区别)
derive	(v., 获得，取得；起源于，来自；提取，衍生（化学物质）)
diminish	(v., 减弱，降低，减少；贬低，轻视)
discriminate	(v., 区分，辨别；歧视，区别对待)
discrete	(adj., 分离的，各别的)
dimension	(n., 大小，尺寸；（空间的）维度；范围，规模；方面，部分), (v., 切削（或制作）成特定尺寸；标出尺寸)
displace	(v., 取代，代替；使（人或动物群体）离开家园；移动，转移)
dispose	(v., 处理，放置，安排；使易于，使倾向于；丢掉)
distinct	(adj., 不同的，有区别的；清楚的，明显的；确切的)
display	(v., 展示，陈列；显露，表现；（计算机）显示；（为求偶）作炫耀行为), (n., 展览，陈列；表演；（计算机屏幕上的）显示，显示器；流露，表现；炫耀行为)
distort	(v., 扭曲，使失真；歪曲，曲解)
distribute	(v., 分发，分配；配送，分销；散布，使分布；（印刷）拆（版）还字；周延)
document	(n., 文件，公文，文献；证件，单据；（计算机）文件，文档), (v., 记录，记载（详情）)
diverse	(adj., 不同的，各式各样的)
draft	(n., 草稿，草案；汇票；<美>通风气流，穿堂风（=draught）；征兵；<美>（职业球队的）选拔队员制), (v., 起草，草拟；选派，派遣；<美>征召，征召……入伍；<美>挑选，选拔（运动员）；作草图，绘样), (adj., （动物）驮重物的，负重的；（啤酒）散装的；草拟的)
drama	(n., 剧本，戏剧；戏剧研究，戏剧艺术；戏剧性场面，戏剧性事件；激动，刺激)
dominate	(v., 统治，支配；在……中占首要地位；俯视，高耸于；占绝对优势)
domestic	(adj., 国内的，本国的；家用的，家庭的；喜爱家庭生活的，乐于操持家务的；非野生的，驯养的), (n., 家庭纠纷，家庭矛盾；佣人，家仆；<美>国货，本地产品)
domain	(n., 领域，范围；领土，势力范围；（因特网上的）域；（函数的）定义域；地产)
duration	(n., 持续，持续时间)
dynamic	(adj., 充满活力的，精力充沛的；动态的，发展变化的；力的，动力的), (n., 动力，活力；相互作用，动态；动力学)
economy	(n., 经济；节省，简练；经济舱), (adj., 经济实惠的)
element	(n., 基本部分，要素；元素；有点，少量；一群人；恶劣天气（the elements）；基本原理；适宜的环境；电热元件，电热丝；（基督教圣餐中的）面包和酒)
emphasis	(n., 重要性，重点强调；重读，强调；（表达的）强有力)
empirical	(adj., 经验主义的，以经验为依据的)
edit	(v., 编辑，校订；编选；剪辑；主编), (n., 编辑，校订，剪辑)
enable	(v., 使能够，使可能；激活，启动；准许，授权)
eliminate	(v., 剔除，根除；对……不予考虑，把……排除在外；（比赛中）淘汰；铲除，杀害；（生理）排除，排泄；消去)
emerge	(v., 浮现，出现；显露，知悉；恢复过来，幸存下来；形成，兴起)
encounter	(v., 遭遇；偶遇，邂逅), (n., 偶遇，邂逅；经历，体验；冲突；比赛，交锋)
energy	(n., 能力，力气；精力，活力；能源；能，能量)
enforce	(v., 实施，执行（法律、规章）；强迫，迫使；<旧>竭力使人接受（要求，论点）)
enormous	(adj., 巨大的，极大的；<古>凶暴的，极恶的)
entity	(n., 实体，独立存在体)
environment	(n., 自然环境，生态环境；周围状况，条件；工作平台，软件包)
ensure	(v., 确保，保证；保护，使安全)
enhance	(v., 增强，提高，改善)
estimate	(v., 估计；判断，评价), (n., 估计，估价；估价单；看法，判断)
erode	(v., 侵蚀，腐蚀；削弱，降低)
equivalent	(adj., 等同的，等效的), (n., 对等的人（或事物），对应的人（或事物）；当量（equivalent weight）)
error	(n., 错误，差错；（棒球、网球等运动中的）失误)
estate	(n., 财产，遗产；大片私有土地，庄园；<英>住宅区，工业区；<旧>社会阶层；（生活）状况，条件)
equate	(v., （使）等同；使（两个或两个以上事物）相等，使平衡)
establish	(v., 建立，设立；证实，确定；发现，找出；使被接受，使得到承认；使（故事的角色）真实；（桥牌）（通过出大牌）使（某）花色所剩的牌都能赢)
exceed	(v., 超过，超出；超越（限制）；优于，胜过)
equip	(v., 装备，配备；使有所准备，使能够胜任)
ethic	(n., 行为准则，道德规范，伦理标准；信仰), (adj., （与）道德规范（有关）的，（与）伦理（有关）的（=ethical）)
eventual	(adj., 最终的，结局的；<古>有条件的)
evident	(adj., 清楚的，显然的)
ethnic	(adj., （有关）种族的，民族的；少数民族的；具有民族特色的，异国风味的；既非基督教亦非犹太教的，异教徒的), (n., 少数民族成员，某民族群体的人)
evaluate	(v., 评价，评估，估值；求（方程式，公式，函数）的数值)
expert	(n., 专家，能手，权威), (adj., 专业的，熟练的), (v., 当专家)
expand	(v., 扩大，增加；扩展，发展；细谈，详述；变得更自信（善谈）；（宇宙）膨胀)
exploit	(v., 剥削，压榨；利用（……为自己谋利）；运用，发挥；开发，开拓), (n., 英勇事迹，壮举；大胆的表演，不凡的身手)
explicit	(adj., 清楚明白的，明确的，详述的；直截了当的，坦率的；赤裸裸表现性爱（或暴力）的，露骨的), (n., （手稿、早期印刷品或礼拜仪式上唱诗的）结束语)
exhibit	(v., 表现出；卖弄，炫耀；提出（证据等）；展览，展出), (n., 展品；（法庭上出示的）证物；<美>展览，展出)
export	(v., 出口；传播，输出；（在计算机中）导出，输出), (n., 出口，输出；出口物，输出品；出口量，出口收入), (adj., 出口的)
evolve	(v., 进化，演化；逐步发展，逐渐演变)
exclude	(vt., （故意）不包括，把……排除在外；认为……不可能，排除……的可能；阻挡；开除（学生）；防止……的发生)
facilitate	(v., 使更容易，使便利；促进，推动)
factor	(n., 因素，要素；等级，系数；因数，因子；遗传因子，基因；（血液中的）凝血因子；代理公司，代理商；<苏格兰>地产管理人，管家；测量水平), (v., 把……作为因素计入，把……包括在内（factor in）；把……作为因素排除，不把……包括在内（factor out）；将……分解为因子；代理经营，（代管）产业；做代理商)
extract	(n., 选段，引文；提取物，汁), (v., 提取，提炼；取出，拔出；摘录；索取，设法得到；开（方），求（根）)
external	(adj., 外部的，外面的；对外的，与外国有关的；外来的，外聘的；（药品等类似物质）外用的), (n., 外表，外部特征)
expose	(v., 暴露，使显露；使面临，使遭受（危险或不快）；揭露，揭发；接触，体验；露出，显露（感情）；使（胶卷）曝光；当众暴露自己的性器官，露阴（expose oneself）；弃（婴孩）于户外让其死去), (n., 揭露，曝光)
federal	(adj., 联邦（制）的；（与）联邦政府（有关的）的；中央集权式的；（美国内战时期）北部联邦政府的), (n., 联邦探员，联邦政府官员；（美国南北战争时期）北部联邦政府支持者)
fee	(n., 费用，酬金；会费，入场费；封地，采邑), (v., 付给（某人）费用)
finance	(n., 财政，金融；资金，财源；财务事务，经济情况), (v., 提供资金；贷款购买，赊购)
file	(n., 文件夹（或箱、柜等）；（计算机的）文档；档案；纵列；锉刀；（与某政策领域相关的）议题，职责), (v., （把文件等）归档，存档；提起（诉讼），提出（申请）；发送（消息或报道）给报社；列队行进；锉平)
finite	(adj., 有限的，有限制的；限定的), (n., 有限之物)
final	(adj., 最终的，结束的；(出现次序)最后的，末尾的；决定性的，不可变更的；无比的，极度的), (n., 决赛；期末考试，课程终结考试；主调音；当日报纸的末版；（飞机进入着陆跑道的）最终边，第五边)
feature	(n., 特点，特征；五官，面貌（特征）；地貌；特写，专题节目；正片； 特点，特征), (v., 以……为特色，以……为主要组成；起重要作用，占重要地位；放映，上演；担任主演)
fluctuate	(v., 波动，起伏不定；使波动，使动摇)
flexible	(adj., 灵活的；柔韧的，易弯曲的)
focus	(n., 重点，中心点；关注，注意；震源；目的，意图；焦距；病灶；调焦装置；目的明确，专注；（椭圆、抛物线等曲线的）焦点), (v., 集中，关注；聚焦，调焦；<语言学>以（句子的一部分）为焦点（或重心）)
found	(v., 创办，成立；建造，兴建；根据，以……为基础；熔铸，铸造), (adj., 偶然（或意外）发现的；装备好的；<英>（用餐、供暖）不另外收费的), (v., 找到，找回；发现，发觉；（经过研究）找出，查明（find 的过去式和过去分词形式）)
foundation	(n., 地基，基础；基本原理，根据；基金会；建立，创办；（化妆打底用的）粉底霜)
framework	(n., (建筑物或物体的）构架，结构；参照标准，准则；(社会、法律、政治等）框架)
formula	(n., 计划，方案；配方，处方；公式，方程式；分子式，结构式；配方奶，代乳品；（特定场合的）惯用词语，套话；（影片、书籍等的）套路)
forthcoming	(adj., 即将发生的；乐于提供信息的，愿意提供帮助的；现成的，可得到的), (n., 来临)
format	(n., 总体安排，计划，设计；（书或杂志的）开本，版式；（录像、激光唱片、磁带等的）格式), (v., 为……编排格式；格式化)
function	(n., 功能，职责；宴会，典礼；函数，应变量；由其他事情造成的结果；子例行程序，子例程；官能团，功能团), (v., 工作，运转；行使职责，发挥功能)
fund	(n., 基金，专款；资金，钱款；基金会；储备量), (v., 资助，为……提供资金)
fundamental	(adj., 根本的，基本的；必需的，必不可少的；不能再分的), (n., 基本原理；基音，基频)
furthermore	(adv., 此外，而且)
gender	(n., 性别；（语法中的）性；（总称）男性，女性)
generate	(v., 产生，引起)
generation	(n., 一代（人）；一代人的时间；（产品发展的）代；产生)
globe	(n., 地球，世界；地球仪；球体，球状物), (v., （使）成球状)
goal	(n., 球门；进球得分；目标，目的；（旅行）目的地；（赛跑的）终点), (v., 射门，射门得分)
grade	(n., 等级，品级；（工作岗位，官衔等的）级别，职别；成绩，分数；（美国学制）年级；斜坡，坡度；（疾病的）程度，阶段；与纯种杂交改良的牛), (v., 按照级别安排或分配，分类；给……评分；设定（路面）坡度；（尤指色彩）从一个等级逐渐进入另一个等级；（家畜）与优良品种杂交)
guideline	(n., 指导方针，准则；参考)
identical	(adj., 完全相同的；同一的；（双胞胎）同卵的；恒等的)
grant	(v., 授予，给予；承认), (n., 补助金，拨款；（政府给予的）土地；<正式>给予，授予；合法转让)
highlight	(v., 突出，强调；用亮色突出；挑染), (n., 最好（或最精彩、最激动人心）的部分；挑染的头发；强光部分)
hence	(adv., 因此；之后)
hypothesis	(n., 假说，假设；（凭空的）猜想，猜测；前提)
hierarchy	(n., 等级制度；统治集团；等级体系)
guarantee	(v., 确保，保证；担保，为……作保；保修，包换), (n., 保证，担保；保修单，质量保证书；担保金，抵押品)
ideology	(n., 意识形态，思想体系；<古>观念学；<古>空想)
illustrate	(v., 加插图于；说明，阐明；证明，证实)
identify	(v., 认出，识别；查明，确认；发现；证明（身份），表明；认同，理解；认为……和……一致；和（某人）打成一片)
immigrate	(v., （从外地）移居，移民；使移居入境)
ignorant	(adj., 无知的，（对某事物）不了解的；<非正式>无礼的，粗鲁的；暴躁的，易怒的)
image	(n., 形象，印象；影像，映像，图像；比喻，意象；画像，塑像，雕像；酷似另一个人的人；（人或事物）外形，外表；像点；硬盘备份；（圣经）偶像), (v., 作……的像，描绘……的形象；（以探测器或电磁束）扫描出……的直观图；幻想，想像)
implicate	(v., 使牵连其中，涉及；表明（或意指）……是起因；暗指，暗示), (n., （主逻）蕴（涵）之物)
implement	(v., 执行，贯彻；为……提供工具), (n., 工具，器具；<苏格兰>履行；手段)
implicit	(adj., 含蓄的，未言明的；内含的，固有的；无疑问的，无保留的；（函数）隐式的，隐的)
impact	(n., 撞击，冲击力；巨大影响，强大作用), (v., 冲击，撞击；挤入，压紧；（对……）产生影响)
incentive	(n., 激励，刺激)
imply	(v., 暗示，暗指；意味着；必然包含)
income	(n., 收入，收益)
incorporate	(v., 包含，合并；组成公司；掺和，混合（成分）；使具体化，体现), (adj., 合成一体的，合并的；具体化的；组成公司（或社团）的)
impose	(v., 强制推行，强制实行；把（自己的观点、信仰等）强加于；打扰，麻烦；把（活字页）拼版；欺骗)
incidence	(n., 发生率；入射)
index	(n., 索引；（物价和工资等）指数；指标，量度；幂，根指数；指针), (v., 为……编索引，将……编入索引；使指数化，将（工资）等与（物价水平等）挂钩；（机器，部件）转位)
incline	(v., （使）倾向于；点头；（使）倾斜；赞同（某人，某事）), (n., 斜坡，倾斜)
induce	(v., 引诱，诱使；引起，导致；给（孕妇）引产，（用药物）催生；归纳出)
inherent	(adj., 内在的，固有的；<法律>（权利，特权）固定属于（某人）的；（形容词）作定语和表语时意义相同的)
infrastructure	(n., 下面结构；永久性军事设施；基础设施，基础建设)
infer	(v., 推断，推论；暗示，暗指)
inevitable	(adj., 必然发生的，不可避免的；总会发生的，惯常的), (n., 必然发生的事，不可避免的事)
individual	(adj., 单独的，个别的；个人的；独特的，与众不同的), (n., 个人，个体；与众不同的人，有个性的人；某种类型的人)
indicate	(v., 表明，标示；象征，暗示；间接提及，示意；指示，指出；<英>（用灯光或手臂）打行车转向信号；有必要，被建议)
initiate	(v., 开始实施，发起；使了解，传授；（尤指在秘密仪式上）使加入，接纳), (n., 新加入某组织的人，新入会的人)
injure	(v., 使受伤，弄伤；损害，伤害（名誉、自尊等）；<古>冤枉（某人）)
inspect	(v., 检查，审视；检阅，视察；进行检查，进行视察)
innovate	(v., 革新，创新)
insert	(v., 插入，嵌入；（在文章中）添加，加插；使参与（活动）；（肌肉或其他器官）附着于（尤指移动部分）), (n., 插入物；（尤指）插页，附加页；（电影等的）插入镜头)
initial	(adj., 开始的，最初的；（字母）位于词首的), (n., （姓名的）首字母), (v., 用姓名的首字母作标记（或签名）于)
inhibit	(v., 抑制，约束；使拘束，使尴尬；降低（酶等）的活性；禁止（神职人员）司神职)
input	(n., 投入，输进；输入的信息；（为帮助某人做出决定而提供的）建议，意见；讯息输入端；（输入机器供其使用的）电力；输入框), (v., 输入（信息）)
insight	(n., 洞悉，了解；洞察力)
integrity	(n., 正直，诚实；完整，完全；职业操守；（电子数据的）集成度)
intense	(adj., 很大的，十分强烈的；严肃紧张的，激烈的；热情的，热切的；专注的，认真的)
intelligent	(adj., 聪明的；有智力的；智能的)
institute	(n., 研究所，学院，协会；（尤指与法律相关的）注释，论述), (v., 制定（制度、规则等）；提出（诉讼）；任命，授予……职位（尤指圣职）)
instruct	(v., 指示，吩咐；教授，指导；聘请（律师），托办；通知；（法官向陪审团）建议，作说明)
integrate	(v., （使）合并，成为一体；（使）加入，融入群体；（使）取消种族隔离；求……的积分；表示（面积、温度等）的总和，表示……的平均值), (adj., 整合的)
instance	(n., 例子，实例), (v., 举……为例)
integral	(adj., 必需的，必要的；作为组成部分的；完整的；整的，积分的), (n., 积分；完整)
intermediate	(adj., 居中的，中间的；中等程度的，中级的), (n., 中级水平者，中级学生；中间事物；（化合物）中间体), (v., 充当调解人，斡旋)
interact	(v., 相互交流，互动；相互作用，相互影响)
invest	(v., 投资；投入（时间或精力）；赋予，授予；<旧>给……穿衣；<旧>包围，围攻)
investigate	(v., 侦察（某事）；调查（某人）；研究)
internal	(adj., 内部的，体内的；内政的，国内的；本身的，本质的；内心的；<英>（大学生）本校生的), (n., 内部部件，内部特征；内脏)
interval	(n., 间隔，间隙；幕间休息，中场休息；音程)
intrinsic	(adj., 内在的，固有的)
interpret	(v., 解释，说明；口译；把……理解为；演绎)
intervene	(v., 干预，干涉；插话，打岔；干扰，阻挠；发生于其间，介于中间；调停，斡旋)
invoke	(v., 行使，实施（法权）；援用，援引（法律）；提及，援引（某人、某理论、实例等作为支持）；提及（某著名人物）；唤起，引起（感情或想象）；（尤指向神灵）祈祷，祈求；用法术召唤（魔鬼）；（计算机）调用，激活)
isolate	(v., 孤立，分离；隔离；单独考虑，区别看待；使（某物质、细胞等）分离), (n., 被隔离的人（或物）；（用于研究的）分离菌，隔离群), (adj., 孤独的，孤立的)
involve	(v., 牵涉，涉及；包含，需要；使陷入，使卷入；（使）参加，加入；使承担，使面对)
job	(n., 工作，职业；零工，任务；职责，责任；<非正式>罪行，（尤指）盗窃；<非正式> 东西，物件；费力的事；幸运的事；刺，捅；<非正式>东西，物件), (v., 刺，捅；（尤指经纪人小规模操作）买卖股票；<非正式>欺骗，出卖；假公济私，营私舞弊)
journal	(n., 杂志，期刊，报纸；日记，日志；（会计）日记账)
item	(n., 项目，条款；一件商品（或物品）；一则，一条（新闻）；（关系亲密的）一对), (adv., （用于介绍清单上逐个项目之前）又，此外还有), (v., 逐条列出，记下)
issue	(n., 议题，争论点；（报纸、杂志等的）期，号；发放，分配；（新股票或邮票等的）发行；子女，后嗣；流出，发出；<旧>结果，后果), (v., 发表，颁布；分发，分配；正式发行；流出，发出；由……产生，由……得出)
labour	(n., 劳动；任务，（一段时间的）工作；劳工，工人，劳动力；分娩，临盆；工会；（英国）工党), (v., 劳动，劳作；努力做（困难的事）；费力地行进；误以为，为……所蒙蔽；一再重申，反复说明；<古>耕（地）), (adj., 工党的，支持工党的)
label	(n., 标签，标牌；称号，绰号；商标，品牌；唱片公司；（计算机）标记；示踪剂；带垂饰的横带), (v., 贴标签；把……不公正地称为；用示踪剂使（物质等）示踪)
layer	(n., 层；层次，等级；摆放者，铺设者，产卵者；压条), (v., 分层放置；把（头发）分层剪短；用压条培育（植物）)
justify	(v., 是……的正当理由；对……作出解释，为……辩解；使（文本）对齐；（在上帝的眼中）称义，使有义；证明合法；整理版面)
levy	(v., 征收（罚款、税款等）；扣押财产（以执行判决）；<古>征兵；发动（战争）), (n., 征收额，税款；（为执行判决而进行的）财产扣押；征兵)
lecture	(n., 讲座，讲课，演讲；训斥，告诫), (v., （尤指在大学里）开讲座，讲课；训斥，告诫)
legislate	(v., 通过立法实施；制定法律，立法)
legal	(adj., 法律允许的，合法的；与法律有关的，法律的；（与衡平法相对）普通法或成文法确认的；神学律法的，与神学律法有关的；<美>（纸张）标准大小的)
licence	(n., 许可证，执照；许可，准许；（言论或行动的）自由，不受拘束；（做错事的）诱因，借口), (v., 给……发许可证，批准；就……发许可证；按协议特许，授权)
link	(v., 连接；与……有关联；挽住，钩住), (n., （事物间的）联系，关系；（交通上的）联系；（链状物的）环，节；（超文本）链接；<美>一节香肠；令（长度单位，1令等于1测链的百分之一，即7.92英寸）；（行路时照明用）沥青和麻屑火把)
liberal	(adj., 思想开明的；自由主义的，支持变革的；（加拿大、英国等国）自由党的；慷慨的，大量给予的；通识（教育）的，文科的；不确切的，不拘泥字面的；自由主义神学的), (n., 思想开明的人；自由主义者，支持变革的人；（加拿大、英国等国的）自由党党员，自由党支持者)
manual	(adj., 手工的，体力的；手动的，用手操作的), (n., 使用手册，说明书；手动换挡的车辆；风琴键盘；（牧师主持圣礼时用）礼仪书)
mature	(adj., 成熟的，理智的；成年的，发育完全的；发酵成熟的，酿成的；中老年的；技艺精湛的，技巧娴熟的；审慎考虑的，深思熟虑的；到期（应该支付）的；（某些食品或饮料）可立即食用的；（经济，行业，市场）成熟的，发展余地不大的), (v., （使）成熟，（使）长成；变理智，（举止）变成熟；酿成，制成；到期)
maximise	(vt., 把……增加到最大限度；尽量增大（maximize 的英式拼写）)
likewise	(adv., 同样地，类似地；（表示感觉相同）我也是，我有同感；也，还)
locate	(v., 确定……的位置，探明；设立，建立；迁居，开办公司；位于（be located in）)
logic	(n., 逻辑，（做某事的）道理；推理方法，逻辑学；（事实或事件的）规律，相互联系；（计算机或电器的）逻辑操作)
maintain	(v., 保持，维持；维修，保养；断言，主张；赡养，抚养；<旧>支持，维护)
manipulate	(v., 操纵，摆布；操作，使用；正骨，推拿；篡改；巧妙地移动（某物），巧妙地处理（某事）；校正，转移（储存在计算机上的信息）)
major	(adj., 重大的，主要的；严重的；大调的，大音阶的； <旧>（公立学校中置于学生姓氏后，表示两兄弟中）大的，年长的；主修的；大（项）的), (n., 主修科目，专业；陆军少校，（美国）空军少校；（某专业的）主修学生；<美，非正式>职业棒球大联盟；大型公司，重要企业；成年人，已达到法定年龄者；（军乐队中主管某一乐器部的）乐器长；大调，大音程； 大项，大前提；主要世界性组织（或公司、比赛）), (v., （在美国大学）主修，专攻)
margin	(n., 页边空白；差额，幅度；盈余，利润；余地，备用的时间（或空间、金钱等）；边缘，非主体部分；保证金，押金；<澳新>额外报酬), (v., 给……加上边；预付定金，交押金；<古>页边做注释或总结)
medium	(n., 媒介，媒体；方法，手段；（艺术创作）材料，素材；灵媒，巫师；培养基；环境；中等，中号；存储（或打印）介质；（颜料）溶剂（如油或水）；（品质、状态）中等，中庸), (adj., 中等的，中间的，适中的；五分熟的，半熟的；（程度、强度或数量）平均的；（颜色）不深不浅的，适中的；（投球，投球手）中速的)
medical	(adj., 医学的，医疗的；内科的), (n., 体格检查，健康检查)
mental	(adj., 存在于大脑中的，思考的；精神的，思想的，智力的；精神病治疗的，精神健康的；<非正式>疯癫的，不正常的)
media	(n., 新闻媒体，传媒（medium的复数形式）；媒体工作者；（尤指血管壁的）中间层（复数mediae）；浊塞音；中脉)
mechanism	(n., 机械装置，机件；途径，方法；（生物体内的）机制，构造；机械论；（产生自然现象等的）物理过程)
mediate	(v., 调停，斡旋；影响……的发生，使……可能发生；促成（协议），找到……的解决办法；引起，形成；传递，传达；连接，沟通；处于中间地位), (adj., 间接的；居间的，介于中间的)
minimise	(vt., 使缩到最小；成极小；求最小值)
migrate	(v., （候鸟或动物）迁徙；（尤指为找工作）移居，迁移；转移（从一个部位移到另一部位）；把（程序，硬件）从一系统转移到另一系统；改用操作系统)
method	(n., 方法，办法；条理；体验派表演方法)
minimal	(adj., 极小的，极少的；极简抽象艺术的；简朴的，朴实无华的；极简的（指短小乐句不断重复并逐渐变化）；最小差别的)
minimum	(adj., 最小的，最低限度的), (n., 最小值，最低限度), (adv., 最低，至少)
military	(adj., 军事的，军队的；陆军的；军人般的，军人作风的), (n., 军人，军方)
ministry	(n., （政府的）部，部办公楼；（全体）牧师；神职，神职任期；一任首相的执政期；照料，服务)
mode	(n., 方式，做法；（机器、设备的）运行方式，状态；（衣着、艺术等的）形式，风格；<非正式>（思想、情感或行为的）状态，状况；（音乐的）调式；众数（一组数字中出现次数最多的数）；（逻）（模态命题的）式，形式；（物理）模（式），波型；（模态命题的）式，形式)
negate	(v., 否认，否定；使无效，取消；使（单词或短语）变否定)
monitor	(n., 显示器，监控器；监视仪，监护仪；监督员，监察员；（学校里的）班长，级长；（电台的）监听员；扬声器；巨蜥；浅水重炮舰), (v., 监视；监听（外国广播或电话）；监控（无线电或电视传输信号）)
modify	(v., 修改，改进；修饰，限定；缓和，使温和；使改形，使转化；变（音）)
minor	(adj., 较小的，次要的，轻微的；（疾病）不严重的，（手术）小的；小调的，小音阶的；未成年的；数量少的，范围小的；（逻）小（项）；<英，旧>（两兄弟或同姓男生中）年龄更小的), (n., 未成年人；辅修课程；（美国大学中的）辅修生；（乐）小调，小音程；（逻）小项，小前提；禾夜蛾), (v., 辅修)
network	(n., 网络，网状系统；人际关系网，联络网；计算机网络，互联网；广播网，电视网), (v., 使（计算机）联网；（尤指工作中）建立关系网，建立人脉；对（电视或广播节目）进行联播)
mutual	(adj., 相互的，彼此的；共同的，共有的；（保险公司、建筑协会等）互助的), (n., 互助公司)
motive	(n., 动机，目的，原因；（文艺作品、音乐的）艺术思想，主题), (adj., 引起运动的，起推动作用的), (v., 使产生动机，激起)
neutral	(adj., 中立的，不偏不倚的；中性的，不带感情色彩的；暗淡的，素净的；（化学中）中性的，非酸非碱的；不带电的), (n., （车辆排挡的）空挡；中立者，中立国；素净色，中和色；不活动，停滞；不带电的接触点)
nevertheless	(adv., 然而，不过)
norm	(n., 社会准则，行为规范；标准，平均水平；常态，平常事物；模方；<澳，非正式>诺姆（指整日呆在家中看电视的懒人，尤指看体育节目）)
nonetheless	(adv., 然而，尽管如此)
notwithstanding	(prep., 虽然，尽管), (adv., 尽管如此), (conj., 虽然，尽管)
objective	(n., 目的，目标；出击目标（尤指在军事攻击中)；（望远镜或显微镜中的）物镜；出击目标（尤指在军事攻击中）；宾格), (adj., 客观的，不带个人情感的；客观存在的；宾格的；目标的)
notion	(n., 概念，想法；缝纫用品；一时的念头，突发的奇想)
obvious	(adj., 明显的，显然的；明确表示的，毫不掩饰的；平淡无奇的，缺乏想象力的；合情合理的，当然的)
nuclear	(adj., 核子的，原子核的；核武器的；原子能的，核能的；核心的，中心的；细胞核的，构成细胞核的)
normal	(adj., 正常的，标准的；（身心）健康的，（人）普通的；（线或线性特征）正交的，垂直的；（盐溶液）与血液的盐浓度相同的；正（断层）的；平常的，通常的), (n., 常态，通常标准；<非正式>正常人，循规蹈矩者；法线，正交)
obtain	(v., （尤指通过艰难的过程）得到，获得；<正式>（规则或情况）存在，通用)
occupy	(v., 使用（房屋、建筑），居住；占据（空间，时间）；使忙于（做某事）；使一直在想；（军事）占领，占据；（尤指为表示抗议而）非法强占（建筑物）；任职，位居)
odd	(adj., 奇怪的，反常的；偶然出现的，偶尔发生的；奇形怪状的，各种各样的；不成对的，不同类的；奇数的；可得到的，可用的；少量的，不重要的；（尤指在双方至少各进一球的情况下）一球险胜的), (adv., （用于数字后）大约，左右)
offset	(v., 补偿，抵销，抵消；衬托出；使偏离直线方向，使与…不在一条直线上；（墨水，刚印好的页面）转印下一页), (n., 抵消物，补偿；偏离量，偏离距离；（测绘）支距；（电压或电流的）偏离；侧枝，短匐茎；（山的）支脉；（建筑）壁阶；胶印法), (adj., 胶印的，平版印刷的；偏离中心的，偏置的)
occur	(v., （尤指意外地）发生；存在，出现；（想法）产生)
ongoing	(adj., 持续存在的，仍在进行的，不断发展的)
output	(n., 产量，作品；产生，生产过程；输出功率；（计算机的）输出信息；输出端), (v., 输出)
overseas	(adj., 外国的，海外的), (adv., 在国外，在海外)
outcome	(n., 结果，效果)
orient	(v., 朝向，面对，使适合；定向放置（某物）；确定方位，认识方向（orient oneself）；引导；使熟悉，帮助适应), (n., <旧>东方，东亚诸国（the Orient）；（优质珍珠的）光泽；优质珍珠), (adj., <文>东方的，东方国家的；（尤指宝石）光彩夺目的；（太阳等）冉冉上升的，（白昼的光亮等）渐渐变强的)
option	(n., 可选择的事物；选择，选择权；（将来的）买卖选择权利，期权；（计算机程序中的）选项；<英>选修课；（购买新设备，尤其是汽车时提供的）附件，配件), (v., 买卖（某物的）期权)
overlap	(v., （与……）互搭，（与……）复叠；（在关注的问题、承担的责任等方面）部分地重叠，部分相同；（与……）同时发生), (n., （物体的）重叠部分，重叠量；（范围方面的）重叠部分；（两事发生的）重叠时间，交接时期)
overall	(adj., 总的，全面的；所有的，包括一切的), (adv., 全部，总共； 总的说来，大体上), (n., <英>（工作时穿的）罩衣；<英>（上下连身的）工作服，防护服（overalls）；<美>背带工装裤（overalls）；<英>骑马裤，紧身制服裤（overalls）)
panel	(n., 专家咨询组，专题讨论小组；（门等的）镶板，嵌板；控制板，仪表盘；（车身的）金属板；（衣服上的）镶条，饰片；画板；<美>陪审团；<英>国民保健制度（原国民健康保险）医师名单；<苏格兰，法律>被告), (v., 用（木板、金属板等）覆盖，镶)
paragraph	(n., （文章的）段，段落；段落符号；短评), (v., 把（文章）分段)
paradigm	(n., 典范，范例；样板，范式；词形变化表；纵聚合关系语言项)
parameter	(n., 界限，范围；参数，变量；（统计）人口参数)
participate	(v., 参加，参与；<古>分担，分享；<古>具有，带有（特殊的性质）)
perspective	(n., （观察问题的）视角，观点；透视（画）法；（几何）透视关系，投影比例；洞察力，判断力；景观，远景；角度；（声音）立体效果), (adj., 透视的)
passive	(adj., 消极的，被动的；被动语态的；（抵抗）非暴力的；（电路，装置）无源的；（金属）经表面钝化处理的，钝化的), (n., （动词的）被动语态形式；被动语态（the passive）)
period	(n., 一段时间，时期；（人生或国家历史的）阶段，时代；（地质年代划分的）纪；课时，节；（练习、训练或学习的）时段；（妇女的）月经，经期；（体育比赛的）局；<美>句号，句点；（物理）（振动或循环的）周期；（天文）自转（或公转）周期；（数学）（周期函数的）周期；（化学）周期元素；（修辞）完整句；（乐）乐段，乐节), (adj., 具有某个时代特征的), (adv., <美>到此为止，不再说了)
persist	(v., 继续存在，持续；坚持，执意；坚持说，反复说)
partner	(n., （跳舞、玩游戏等的）搭档，同伴；（合伙企业的）合伙人；（生意、组织或国家的）伙伴；配偶，（同居的）伴侣，情人), (v., 成为搭档，合伙)
percent	(n., 百分之……；部分), (adj., 百分之……的), (adv., 以百分之……地，每一百中有……地)
perceive	(vt., 认为，理解；察觉，注意到；意识到)
parallel	(adj., 平行的；相似的，同时发生的；（计算机）并行的；并联的), (n., （人或事物的）相似的手法，共同点；相似的人（或物）；（地球的）纬线，纬圈；（印刷）平行符号), (v., 与……相似；与……同时发生；与……并行；与……相当，比得上), (adv., 与……平行)
phenomenon	(n., 现象；杰出的人，非凡的人（或事物）；（哲学）现象)
philosophy	(n., 哲学；哲学体系，思想体系；人生哲学，生活（工作）准则；（某一知识或经验领域的）理论基础研究，基本原理)
plus	(prep., 加；外加，而且；（温度）零上), (adj., （在数字后）多，余；略高于标准的；零上的，正的；有利的；正电的), (n., 加号，正号；（数字的）加法；好处), (conj., 而且；加上)
phase	(n., （发展或变化的）阶段，时期；做出某种行为的短时期；（动物生活周期或年周期的）阶段，期；（月亮的）位相，盈亏；同步，协调；（化）相；（动）（由遗传或季节引起的）动物颜色变化（期）；（物理）相位，相角；（线圈的）匝，（多相电机或电路的）连接；（语言学）（系统语法用语）相（指链接动词与后续动词的关系）；相结构（含有链接动词和后续动词的结构）), (v., 分阶段进行；（物理）使相位同步，使定相)
portion	(n., （某物的）一部分；（尤指餐馆中食物的）一份，一客；（责任、过失、职责等的）一份，一部分；<法律>（根据法律赠与或遗留给继承人的）一份财产；<古> 命运，天数), (v., 分配；<古> 给（新娘）嫁妆)
physical	(adj., 身体的，肉体的；物质的，有形的；外形的，外在的；物理的，物理学的；根据自然规律的，符合自然法则的；粗暴的，粗野的；性欲的，肉欲的；（人）喜欢动手动脚的；肢体活动的), (n., 体格检查；（股票）（与期货相对的）现货股票)
positive	(adj., 乐观的，有信心的；积极的，建设性的；赞成的，支持的；确信的，肯定的；<非正式>完全的，绝对的；证据确凿的，明确的；阳性的；良好的，有助益的；正数的，大于零的；正电的，正极的；（摄影）正片的，正像的；赢利的；（语法）（形容词，副词）原级的；（主哲）实证的，实在的；（占星）（风宫，火宫）积极的), (n., 优势，优点；正片；阳性结果；正数；（语法）原级形容词，原级副词)
pose	(v., 造成，引起（威胁、危险、问题等）；提出（问题）；（为照相、画像等）摆好姿势；假扮，冒充（pose as）；（举止或穿戴）装腔作势，招摇过市；<古>把……难住，使为难), (n., （为拍照、画像等摆的）姿势；故作姿态，装腔作势)
policy	(n., 政策，方针；(处事) 原则，策略；保险单)
precede	(v., 处在……之前，先于；在……之前做（或说）；比……更重要，比……（级别）更高)
presume	(v., 料想，（不肯定地）认为；假设，设想；（法律上或官方）假定，推定；擅自，冒昧；意味着；<正式>擅作主张，冒昧)
preliminary	(adj., 初步的，预备的), (n., 初步行动，准备工作；预赛，预试)
predominant	(adj., 明显的；占主导地位的，占支配地位的)
precise	(adj., 精确的，准确的；恰好的，确切的；（人）严格的，一丝不苟的)
practitioner	(n., （医学界或法律界的）从业人员，执业者；<正式>从事者，实践者)
potential	(adj., 潜在的，可能的), (n., （事物的）潜力，可能性；（人的）潜能，潜力；电势，电位，电压)
previous	(adj., 以前的，先前的；（时间或顺序上）稍前的；<非正式>过早的，过急的), (n., <英，非正式>前科，犯罪记录)
predict	(v., 预言，预计，预卜)
primary	(adj., 主要的，首要的；<英>小学教育的，初级教育的；初级的，原发性的；最基本的，最根本的；第一手的，直接的；（有机化合物）连上一个碳原子的；（多指胺）（氨基酸顺序）一级的), (n., （选举过程中的党内）初选（=primary election）；原色；初级飞羽；主星；初级线圈，原线圈)
process	(n., 步骤，程序；（自然或偶然的）变化过程；（为达到某目标的）过程，进程；制作方法，加工方法；<法律>传票；（生，剖）端突，突起), (adj., （印刷）三原色的，三色版的； 经过特殊加工的；照相板的), (v., （用化学物品或机器）处理，加工；审核，受理（正式文件或请求）；（计算机）处理（数据）；冲洗（照片）；加工（食品）；<正式>列队行进；把（头发）弄成直发)
principal	(adj., 最重要的，首要的；本金的，母金的), (n., <美>（美国公立中小学的）校长；<英>（英国的）大学校长，学院院长；（企业或机构的）负责人；（音乐会、戏剧、芭蕾舞剧、歌剧中的）主角演员；（管弦乐队每一乐器组的）首席演奏者；（有利息的）本金，资金；（法律和商业事务中的）当事人，委托人；关键人物；（某些行业）完全合格的开业者；<英>（负责某一部门的）高级公务员；主犯，首犯；<史>决斗者；（支撑檩的）主椽；（管风琴的）主音栓)
prime	(adj., 主要的，首要的；优质的，第一流的；最可能的，最适合的；最理想的，最典型的；最初的，原始的；素（或质）数的（如2，3，5，7，11）；互为素或质数的), (v., 事先指点，使（某人）做好准备；把（某事物）准备好，使备用；给（表面）涂上底色), (n., "盛年，壮年时期；质数，素数；上标符号（），（数字后）分钟（或英尺）符号；（八个防御姿势的）第一姿势；（自行车比赛中设特别奖的）特设行程；<古>起始，原初；晨经，晨祷（传统上于白天中的第一个小时即早晨六点所做的祈祷，现罕用）")
principle	(n., （行为）准则，（道德）原则；道义，正直；基本原则，基本法则；（机器等或自然界的）原理，定律；（宗教或政治的）主义，信条；起源，本原；本质，实质；（化）成分，要素)
prior	(adj., 先前的，事先的；<正式>优先的，更重要的；<正式>在前面的（prior to）), (n., <美，非正式>犯罪前科；小修道院院长；大修道院副院长；托钵会会长)
proceed	(v., 开始行动，开展；<正式>继续做（或从事、进行）；（完成其他事后）继续做某事；<正式>行进，前往；起诉某人；来自，出自), (n., （某个事件或活动的）收入，收益)
priority	(n., 优先事项，最重要的事；优先，优先权，重点；<英>优先通行权), (adj., 优先的)
prohibit	(v., （通过法律、条例等）禁止；阻止，使不可能)
professional	(adj., 职业的，专业的；非常内行的，极为称职的；（人）职业性的，非业余的；由职业人员参加的；<非正式，贬>（人）坚持某种活动特征（或特点）的), (n., 专业人员，专业人士；内行，专家；职业选手；（受雇于高尔夫或网球协会的）职业教练)
prospect	(n., 可能性，希望；预期，展望；（尤指事业的）成功机会，前景；有望成功的人，有前途的人；可能的顾客，潜在的主顾；<正式>（尤指从高处看到的）景象，景色；潜在矿藏或矿床), (v., 勘探，勘察；寻找（商业机会）)
project	(n., 项目，计划；（学校的）课题，研究项目；<美>廉租房区，公共房屋区), (v., 预计，推算；计划，规划；伸出，突出；投掷，喷射；投射，投影；展现，表现；使（声音，尤指嗓音）扩及远处；传播；想像（自己、场景等）在另一地点或时间；（尤指无意地把情感、愿望）投射转移（给别人）；使（某人）迅速成功，让（某人）获得更好的工作；作（曲线）的射影图；把（地球，天空等）投影在平面上)
promote	(v., 促进，提倡；升职，晋升；促销，推广； 将（运动队）晋级；使（学生）升年级；负责筹办，主办（大型活动，如音乐会或体育比赛）；促使（议会私法议案）通过；使（卒）升格为（尤指后等）；<英>（先打大牌）使（小牌）赢得一墩；使（催化剂）更活泼)
psychology	(n., 心理学；心理特点，心理状态；心理影响；心计，善解人意)
protocol	(n., 礼仪，礼节；国际议定书，协议；条约草案，（协议或条约的）附件；（协定，公约）修正案（或增补）；（数据传递的）协议，规约；科学实验计划，医疗方案；（科学实验结果的）官方记录), (v., 以协议形式发布；拟定)
purchase	(n., <正式>购买，采购；<正式>购买的东西；<法律>（非继承性的）财产置得；<正式>紧握，牢牢抓住；（移动重物的）滑轮（或类似装置）), (v., <正式> 购买，采购；<古>（努力或艰难地）获得，得到；（航海）（用滑轮或杠杆）升起，举起（绳，索，锚）)
proportion	(n., 部分，份额；比例；正确的比例，均衡；大小，程度（proportions）；（事情的）重要性，严重性；等比关系), (v., <正式> 使（某物）成比例，使相称；分摊)
publish	(v., 出版，发行（书、杂志等）；（作家、 音乐家等）发表（自己的作品），使（作品）出版；（在互联网上）发表；（在报纸或杂志上）刊登，登载；公布，公开；颁布（法令），宣读（法令，结婚预告）；<法律>向第三方传布（诽谤）)
publication	(n., 出版，发行；出版物，发行物；（信息的） 刊登，公布)
qualitative	(adj., 质量的，定性的，性质的)
random	(adj., 任意的，随机的，胡乱的；（砖石建筑）石头大小不一的；<非正式>奇怪的，不同寻常的), (n., 随意，随机；<非正式>不认识的人，陌生人), (adv., 随机地，胡乱地)
radical	(adj., 根本的，彻底的；激进的，极端的；全新的，不同凡响的；（增减）急剧的，大幅度的；（人，物）原本的，与生俱来的；<美，非正式>顶呱呱的；（外科，医疗）根治的；<英，史>（19世纪）自由党激进派的；（数）根式的，根号的；词根的；（植）根生的), (n., 激进分子； 游离基，自由基；词根；（汉字）偏旁，部首；（数）根式；根号)
quote	(v., 引用，引述；举例说明；将......描述为；开价，报价；为（股票、黄金或外汇）报价；为......打出（某投注赔率）； 为（企业的股份）上市，挂牌), (n., 引文，引语；报价，开价；（股票）报价，牌价；（建成某物或修理某物的）报价单；引号（quotes）)
pursue	(v., 追求，致力于，执行；继续探讨（或追究、从事）；追逐，跟踪，追赶；沿着……前行；追求（某人）；力劝（某人）接受聘用)
ratio	(n., 比率，比例)
range	(n., （变动或浮动的）范围，界限；视觉（或听觉）范围；射程，射击距离；一系列；成套产品，系列商品；山脉；牧场，牧区；靶场，射击场，炸弹试验场；（尤指旧时的）炉灶；一排建筑物；<古>方向，走向；（飞机等交通工具的）续航距离), (v., （在一定的范围内）变化，变动；（按一定位置或顺序）排列，排序；徘徊，四处移动；（文章或讲话）涉及，包括 ；（枪、炮、射击后校准）测距，（用雷达或激光）测距；支持，反对；自然生长，分布；与……联合起来，加入……行列), (adj., <文>（生活方式）有秩序的，安定的)
region	(n., 地区，区域；行政区；<英>（首都以外的）地方（the regions）；身体部位；领域，界)
rational	(adj., （想法、决定等）合理的，基于理性的；（人）理性的，理智的；富有理性的；（数）有理的，有理数的), (n., 有理数)
refine	(v., 精炼，提纯；改进，改善；使……文雅)
recover	(v., 恢复（健康，精神，体力）；康复，复原（be recovered）；（从不愉快的经历中）恢复；（从弱势或困境中）好转，扭转；重新获得，寻回；收回（开支、投资等）；恢复（意识、神志或身体状态）；挽回（地位），弥补（时间损失）；提取（能源或化工品等），回收利用； 给……换上新面), (n., （军事操练）枪还原，收枪（the recover）)
regime	(n., （尤指独裁的）政府，政权；（机构、公司、经济等的）管理制度，组织方法；饮食起居制度，养生法)
react	(v., （作出）反应；起化学反应； (对食物等）不良反应，过敏；（股票价格）回跌)
regulate	(v., （用规则条例）控制，管理；调节，调整；监控，监管；校准，对准（时钟或其他仪器）)
reluctance	(n., 不情愿，勉强；（物理）磁阻)
reinforce	(v., 加强，强化（观点、思想或感觉）；加固，使更结实；给……加强力量（或装备），增援；寻求（或得到）增援), (n., 加固物)
register	(n., 登记表，注册簿；注册员；（人或乐器的）声区，音区；（适合特定场合使用的）语体风格，语域；（印刷，摄影）套准，叠合；<美>现金出纳机；（电子设备的）寄存器；<美>（供暖或制冷设备的）调风口，节气门；（设计图案组成的）条，局部), (v., 登记，注册；（正式地或公开地）发表意见，提出主张；流露出，表达出；注意到，受到注意；（仪器上）显出，显示；把……挂号邮寄；取得（结果），得（分）；（印刷，摄影）套准，叠合)
relax	(v., 休息，（使）放松；放心，镇定；松开，（使）松弛；放宽（规则或法律等）； 减少（关注），分散（注意力）；烫直（头发）)
release	(v., 释放，放走；使出院；把（动物）放生；解救；放开；拉开，松开（装置）；发射，投（弹）；公布，发布；发行，上映；表达，发泄；释放，排放（物质）； 解除（职务或工作），解雇；放弃，让予；使不紧张；开放，解禁), (n., （人或动物的）释放，放出；排放，泄漏；（设备的）松开，拉开；释放装置（如按、拉的装置）；表达，宣泄；解脱，轻松感；放松的机会；新发行的东西；公开，发布；公映；（责任等的）免除，解除；免责书；<法律> 放弃，让予；放弃文书；<美> 传球)
relevant	(adj., 有关的，切题的；正确的，适宜的；有价值的，有意义的)
reject	(v., 拒绝，否决（提议、建议或请求）；摈弃，不接受（信仰或政治制度）；不雇用，不录取；（因质量不好而）废弃；冷落，嫌弃；排异，排斥（移植器官）；（投币设备）拒绝接受（硬币）), (n., 次品，废品；不合格者，被排斥者)
rely	(v., 相信，信赖；依靠，依赖)
remove	(vt., 移开，拿开；除去，废除；把……免职，开除；脱下，摘下；<史，南非> 依法迫迁；远离；不同于，迥异于；<旧> 搬家), (n., <正式> 距离，间距；<史>（一些英国学校中的）年级)
resolve	(v., 解决（问题或困难）；决定，下定决心；作出决议，表决；分解，转化；（使）（症状、病情）消散，消退；解析，解离；分析；（不协和音）转向协和；（当远处物体看得更清楚时）变成；（光学仪器等）分辨；辨析（图表或光谱峰值）), (n., <正式>决心，坚定的信念；<美>正式决定，决议；决定要做的事)
research	(n., （尤指大学或科研机构进行的）研究，探讨；研究工作，调查工作), (v., 研究，探索；为……收集资料，调查)
respond	(v., （口头或书面）回答，回应；作出反应，回应；（对某种治疗）有良好反应；（桥牌）（对同伴的叫牌）作应叫；（会众对牧师）应答，唱和；承担责任), (n., （教堂用语）应答，唱和；（建筑）壁联（与墙相连支承拱的半柱或半墩，尤指在拱廊两端）)
reside	(v., <正式>居住，定居；<正式>存在于；<正式>（权利、权力等）属于；位（于）)
resource	(n., 自然资源；资源（指钱、物、人等）；有助于实现目标的东西，资料；（对付困境所需的）个人素质（resources）；<正式> 谋略，智谋), (v., 向……提供资金（或设备）)
restore	(v., 恢复（某种情况或感受）；使复原，使复位；修复，整修；重新采用，恢复使用；归还)
require	(v., 需要；要求做（某事），规定)
restrict	(v., 限制，控制（大小、数量、范围）；限制（活动或行为），妨碍；约束，管束；（以法规）限制；封锁（消息）)
restrain	(v., 制止，阻止；克制，抑制；控制（某事物）；剥夺……的行动自由（或人身自由），管押；（安全带）缚住（人或其身体部位）)
revenue	(n., （企业、组织的）收入，收益；（政府的）税收；税务局，税务署（the revenue）)
revolution	(n., （思想、工作方式等的）彻底变革；（使用武力、暴力的）革命；旋转；旋转一周；（马克思主义）共产主义革命（The Revolution）；循环)
reverse	(v., 逆转，彻底改变（决定、政策、趋势等）；撤销，推翻（法庭判决）；颠倒，反转；交换，互换（位置、功能）；<美>承认错误，放弃（立场）；倒（车）；（发动机）反向运转；<英>打对方付费的电话；使（铅字，图案）印成白或浅色), (n., 相对，相反（the reverse）；逆向，逆转；倒车挡；<正式>失败，挫折；反面，背面；（翻开的书）左手页，（活页文件的）背面；（硬币或奖牌）反面图案（或刻字）；（美式橄榄球）反向传球，变位传球), (adj., 相反的，反向的；背面的，反面的；（半导体结的外加电压）反向的；（地层）逆断的，冲断的；反身的)
retain	(v., 保持，保留；保存，储存；记住；付定金聘定（尤指律师）；留用（员工）)
reveal	(v., 揭示，透露；表明，证明；展示，显示；（通过神或超自然手段）启示), (n., （电视节目最后的）揭示；门侧，窗侧)
revise	(v., 改变，修正；修改，修订（书刊、估算等）；<英>温习，复习), (n., 修订，校订；（印刷）改样)
rigid	(adj., （方法、体制等）严格死板的，僵化的；（人）顽固的，不通融的；刚硬的，不易弯曲的；（因强烈的感情而）僵硬的，僵直的；精确的), (n., 未铰接的货车)
role	(n., （演员的）角色；作用，职责)
scenario	(n., 设想，可能发生的情况 ；（电影、戏剧等的）剧情梗概；（艺术或文学作品中的）场景)
route	(n., 路线，航线；道路，路途；常规路线，固定路线；<美>（尤指作为送货工作的）例行拜访，递送路线；途径，方法；（用于美国城市间干线公路编号前）公路（Route）), (v., 按特定路线发送（车辆、货物或乘客）；以......线路发送（电话或其他电子信号）)
schedule	(n., 计划（表），进度表；<美>（公共汽车、火车等的）时间表；（价目、费用等的）清单，一览表；（电视或电台的）节目表；<美>（学校的）课程表；<法律> 附件（尤指表格、单据等）；（英国所得税制的）报税单), (v., 安排，预定；列入，收进（正式目录、清单等中）；<英> 把（建筑物）列为文物保护单位)
scope	(n., 范围，领域；（发挥能力的）机会，施展余地；视野，眼界；观测仪器（如望远镜、显微镜等）；（船抛锚时的）缆绳长度；特定论点的数量), (v., 评估，调查（scope sth. out）；确定（规划项目）的范围；<非正式>仔细看，彻底检查)
sector	(n., 区域，部分；（尤指商业、贸易等的）部门，行业；小群体；（尤指军队控制的）分区，防区；（磁盘上的）扇区； 扇形，扇形面；函数尺，象限仪), (v., 把……分成扇形)
scheme	(n., <英>（政府或其他组织的）计划，方案；（用于组织或整理信息的）系统，体系；组合，布局；阴谋，诡计；<苏格兰，非正式>社会住宅区), (v., 密谋，策划；<南非，非正式>认为，猜想；按色调布置)
section	(n., 段，部分；散件，部件；（书、报等的）节，栏；一部分人；（乐队的）组；断面图，剖面图；（数学中的）截面；（手术中的）开刀，切开；（供研究用的动物或植物的）切片；<美> 一平方英里的土地；<美>（柑橘类水果的）一瓣；（法律文件的）款，项；路段；区域；部门，科；<新西兰> 建房用地；（军队的）特定单位；分排，小队；（生物）组（尤指亚属）), (v., <英> 把……关进精神病院；（手术中）把……切开；将……制成切片；切开，切断；被切割成片，被分成部分)
secure	(adj., 稳固的，可靠的；严密把守的，牢固的；安全的，稳妥的；（对自己和自己的能力）有自信的；感到有保障的，没有顾虑的；固定住的，系牢的；秘密的), (v., （尤指经过努力而）获得，得到；使安全，保护；缚牢，将（某物）固定；确保，保证；为（债务或贷款）作抵押，作保；（外科）压迫（血管）止血；停止工作；船抛锚)
seek	(v., 寻找；寻求，谋求；请求（帮助），征求（意见）；试图，设法；找出，找到（seek sb./sth. out）；自然地向……移动；<古>去，前往（某地）)
sequence	(n., 顺序，次序；连续事件（或动作、事物）；（电影中表现同一主题或场面的）一组镜头；（生物学中分子或基因的排列）顺序；模进；（纸牌的）同花顺；序列；（天主教弥撒中圣歌与福音之间的）继续经), (v., 按顺序排列；测定（整套基因或分子成分的）序列；用音序器播放（或录制）音乐)
select	(v., 选择，挑选；（在计算机屏幕上）选定；（进化）决定（特征，生物）是否继续存在), (adj., 精选的，优等的；高级的，奢华的)
significant	(adj., 显著的，相当数量的；重要的，意义重大的； 别有含义的，意味深长的), (n., <古>象征，有意义的事物)
similar	(adj., 相像的，类似的；（几何图形）相似的), (n., <古>相似之人（或物）；顺势药物（指疗效与某些疾病症状相似的药物，为顺势疗法的基础）)
series	(n., 连续，一系列（事件）；（电视、广播等的）系列片，系列节目；丛书，系列出版物；（两队之间的）系列比赛；（电路的）串联；（同时发行的）一套邮票（或货币、硬币）；（由某一公司推出的）系列产品，（尤指）汽车系列；（年代地层学用语）统；（元素的）系；级数，序列项的总和；有共同特征的一组语音，系列（音）；音列)
sex	(n., 性行为，性交；性，性别；雄性，雌性；性器官（用于小说中避免更粗俗或更露骨的措词）), (v., 辨别......的性别，辨识......的雌雄；<非正式> 引起……的性欲)
simulate	(v., 假装，冒充；模拟，模仿；看上去像；计算机模拟), (adj., <古> 虚假的，假装的)
so-called	(adj., （表示不认同）所谓的；叫做……的，号称……的)
shift	(v., （使）移动，（使）转移；（使）转换到（另一个人或另一事物）；（使）改变意见（或信仰等）；<英，非正式>赶快；<美>换（挡）；（计算机）移位；按（计算机键盘上的）Shift 键；<英，非正式>摆脱，消除；<英，非正式>（尤指大量）销售，出售；<英，非正式>狼吞虎咽地吃；<古>含糊其辞，拐弯抹角), (n., 改变，转变；轮班工作时间；轮班工作的人；（计算机键盘上的）Shift 键；（计算机）移位；<美>（机动车的）换挡装置；宽松直筒连衣裙（=shift dress）；<史>长而宽松的内衣；（建筑）错位；（美橄）（开赛前）球员位置的变换；（天文）（光谱线的）偏移；语音演变（sound shift 的简称）；<古>计谋，诡计)
site	(n., （建筑的）工地，用地；（某事发生的）地点，现场；（作某种用途的）场所，场地；网站，站点（=website）；（身体的某个）部位；（城镇、建筑物或纪念碑的）地基，选址；遗址，原址；（帐篷或大篷车内）歇脚的地方), (v., 使坐落在，为......选址)
source	(n., 来源，出处；（问题的）原因，根源；消息人士，信息来源；河流源头，发源地；源（代）码；（电子）源极，电源；（技）源), (v., （从某地）获得；找出……的来源)
somewhat	(adv., 稍微，有点), (pron., 几分；某物)
specific	(adj., 明确的，具体的；特定的；特有的，独特的；有特殊功能的，有特效的；（生物）种的；（关税，税）按数量（根据固定税率）征取而非按货价征取的；（物理）（与参照物同一性质成）比率的), (n., 细节，详情；特效药)
specify	(v., 明确指出；具体说明；把……列入说明书)
sole	(adj., 唯一的，仅有的；专用的，独享的；<古>（尤指女性）未婚的；<古>单独的，没人陪伴的), (n., 脚底；鞋底（不包括后跟）；脚趾和脚弓之间的部分；（刨子等工具的）底部，（高尔夫球棒头的）底端；（船舱或驾驶室的）地面，地板；鳎（鱼）； 脚底), (v., 给（鞋）换底)
sphere	(n., （活动、兴趣、专业知识的）范围，领域；球体，球，球形；社会阶层；势力范围；<文>苍穹，天，天空；<文>天体；天体外壳；地球仪), (vt., 使……成球形；包围；放入球内)
stable	(adj., 稳定的，牢固的；稳重的，沉稳的；（化学结构或物理状态）稳定的), (n., 马厩；（属同一马主或驯马师的）一群赛马；（在同一地方工作或训练的）一批人，（同一公司生产的）系列产品；赛马训练场), (v., 使（马）入厩，把（马）拴在马厩)
statistic	(n., 统计数字，统计资料；统计学（statistics）；（一项）统计数据), (adj., 统计的，统计学的（同 statistical）)
status	(n., 法律地位（或身份）；（尤指在社会中的）地位，身份；高级职位，社会上层地位；重视（或崇尚）程度；状况，情形)
strategy	(n., （尤指为获得某物制定长期的）策略，行动计划；战略，战略学)
straightforward	(adj., 简单的，易懂的；（人）诚实的，坦率的), (adv., 直截了当地，坦率地)
stress	(n., 精神压力，紧张；压力，应力；强调，重要性；（单词）重音，重读，（音乐）加强音；压强；环境恶劣引起的疾病), (v., 强调，着重；重读；焦虑，紧张；使受压力，使受重压)
submit	(v., 呈递，提交；屈服，不得已接受；建议，主张；使经受，使受到)
style	(n., 方式，作风；款式，样式；（尤指服装上的）风尚，流行式样；风格，体；轻松优雅的方式；生活方式；发型；气派，优雅格调；文风，文体；称号，称谓；（植）（花的）花柱；（无脊椎动物的）尾片，尾须), (v., 设计，给……造型；称呼，命名；使合潮流；用刻刀作装饰画)
subsidy	(n., 补贴，津贴，补助金；<史>（议会发给王室的）特别津贴；（特殊场合征收的）税收)
structure	(n., 结构，构造；结构体，（尤指）大型建筑物；周密安排，精心组织；机构，组织，体系), (v., 计划，组织，安排)
subordinate	(n., 部属，下级；从属，次要), (v., 使从属于，使处于次要地位；使隶属，使服从), (adj., 从属的，下级的；次要的)
substitute	(n., 替代品，代替物；（体育比赛中的）替补队员；令人满意的替代物，与之媲美的事物；<苏格兰，法律>副职), (v., 用……代替；（比赛中）替换（运动员）；代替（某人的工作）；（化）取代（分子中的一个或一组原子，尤指氢原子）), (adj., 替代性的)
subsequent	(adj., 随后的，接着的；（河，谷）后成的)
suspend	(v., 暂停，中止；使暂停使用（或生效）；使暂时停职（或停学等）；延缓，推迟；悬，挂；悬浮，漂浮；<法律> （法官或法庭作出的）暂缓执行（判决）；延留（和弦），延长（和音）)
summary	(n., 总结，概要), (adj., 总结性的，概括的；（司法程序）即决的，简易的)
survey	(n., 民意调查，民意测验；考察，调查；（对课题或情况的）全面考察，概述；测量，勘测；测绘图，勘测记录；测量部门；<英> （尤指为欲购房者所做的）房屋鉴定；查勘报告), (v., 做民意测验，做民意调查；（尤指认真地）审视，检查；测量，勘测；<英> （尤指为可能的买家）查勘，检视（建筑物的状况）；全面评述，概述)
sum	(n., 金额，款项；算术，简单计算；总数，总和；全部，一切（尤指数量不大）；<英>计算失误；<英>计算费用), (v., 概括，总结；求……的和，计算……的总数)
survive	(v., （经历事故、战争或疾病后）活下来，幸存；比……活得久，比……长寿；挺过，艰难度过；幸免于难，留存；（靠很少的钱）继续维持生活；设法对付（困难或令人不愉快的事）)
sufficient	(adj., 足够的，充足的；（理由、条件）充足的，充分的)
successor	(n., 继承者，接替的事物；（组织、机器等的）接替物)
supplement	(n., 补充物，增补物；营养片剂，补品；补助，补贴；额外服务费用；（报纸或杂志的）副刊，增刊；（书籍的）补编，附录；（几何）补角), (v., 增加，增补)
sustain	(v., 维持，保持；维持……的生命；遭受，经受；（在体力或精神方面）支持，支撑；承受住……的重量；证实，证明；认可，赞成，确认；（演员）充分表演（角色，人物），扮演), (n., （乐）延音)
tape	(n., 磁带，录音带；录了音的盒式磁带，录了像的盒式磁带；胶带，胶布；（用来绑东西或作界限标记的）布条，线带；（赛跑中的）终点线；卷尺), (v., （用磁带）录音，录像；用胶带粘贴；用带子系紧；<美> 用（绷带）包扎（受伤部位）)
symbol	(n., 象征，标志；符号；代表性的人（物）)
team	(n., （游戏或体育运动的）队，小组；工作队，工作组；（套在一起拉车的）一组牲口（尤指马）), (v., 协作，合作；使（颜色、布料、衣服）相配；（套在一起拉车的）一组牲口（尤指马）)
technical	(adj., 工艺的，技术的；专业的，专门的；严格按照法律意义的，严格按字面解释的；（尤指体育或艺术等活动）技巧（上）的；与机器（或系统）运行相关的，技术性的), (n., <美>（车后架设有机枪的）小卡车)
target	(n., 目标，指标；（攻击的）目标；（批评、嘲笑等的）对象；靶子；目标受众，受影响的人（或群体）；<史> 圆形小盾；（语音）目标), (v., 把……作为攻击目标，把……作为批评的对象；面向，把……对准（某群体）；将（钱款或援助）用于)
task	(n., （尤指困难的或必须定期做的）工作，任务；（尤指语言教学中旨在帮助达到某一学习目的的）活动), (v., 派给……任务；对（手段，能力）要求极高，考验)
technology	(n., 科技，技术；技术设备，先进机器；技术学，工艺学；术语)
technique	(n., 技巧，工艺；（尤指体育或艺术方面的）技巧，技术)
temporary	(adj., 暂时的，临时的；短期的，短暂的), (n., 临时雇员，临时工)
terminate	(v., （使）结束，（使）终止；到达终点站；终止妊娠，人工流产；<美>解雇；<美>谋杀（某人）；在……结尾，以……收尾), (adj., 结束的)
text	(n., （书、杂志等中区别于图片的）正文，文字材料；（演说等的）原文；（学习某课程必读的）课本，教科书；（供讨论或回答问题的）文本，文章；（讨论等的）题目，主题；（尤指科学或学术方面的）文献；（计算机、手机等）文档；短信；（尤指引作布道主题的）圣经经文；（尤指用于手稿的）粗体正楷), (v., （用手机）给……发短信)
theory	(n., 学说，理论；（某一学科基于的）理论，原理；观点，见解)
thesis	(n., 论文，毕业（或学位）论文；论题，论点；（文章的）主题；（黑格尔哲学用语）正题；（诗韵）扬音节)
theme	(n., （谈话、书籍、电影等的）题目，主题；（音乐的）主旋律；（电影、电视节目、广播节目的）主题音乐，主题曲；（学生的）作文；（聚会、房间等的）风格；（句子的）主位；（名词、动词等的）词干；<史>（拜占庭帝国的）行政区), (adj., 以奇想主题布置的), (v., （休闲场所、活动）以……主题)
tense	(adj., 紧张的，焦虑的；（气氛或局势）令人紧张的，引发恐慌的；（身体或肌肉）僵直的，绷紧的；（金属丝等）拉紧的，绷紧的；（语音，尤指元音）紧的), (v., （使）（身体或肌肉）绷紧，（使）变得僵直；变得神经紧张), (n., （动词的）时态)
thereby	(adv., 因此，从而)
tradition	(n., 传统，惯例；传统故事，传说，传统信仰；和著名历史人物有共同品质的人；（神学）圣传)
topic	(n., 题目，主题；一般规则，总论)
trace	(v., 查出，发现，追踪；追溯，追究；描绘（事物的过程或发展），记述；（尤指用手指、脚趾）画（图，线）；勾画……的轮廓，勾勒；（用透明纸覆盖在地图、绘画等上）复制，描摹；（手指、嘴唇等）沿着……移动), (n., 痕迹，遗迹，踪迹；微量，少许；描记图，扫描线；挽绳，缰绳；跟踪，追查；（大脑上的学习或记忆）痕迹，印迹；<西印度，美>小径，小道；交线，迹线；（数）迹)
transfer	(v., （使）转移，搬迁；转移（感情），传染（疾病），转让（权力等）；（使）调动，转职；转会，使转会（尤指职业足球队）；（将所得学分）转到（另一所学校）；转接（电话）；将（钱）转到（另一个账户上）；转让（财产，权利），移交（责任）；转用；转存，转录（资料、音乐等），改编；（旅途中）转乘，换乘；转印（图画，图案）；（通过延伸、隐喻）转变（词义，短语义）), (n., 转移，转让，调动；（运动员）转会；转换，过渡；已调动的人，已转移的东西；（旅行中）转乘，转搭；<美>转车票，换乘票；纸上可转印的图画或图案；迁移（将已习得的行为在新的情况下应用）)
transit	(n., 运输，运送；<美>交通运输系统；通过，经过；（天文）凌日；（天文）中天；（占星）凌；（商标）（尤指用于运货的）“全顺”汽车（Transit）), (v., 经过，穿过；（天文）（行星等天体）经过（另一天体、子午线）；（占星）（行星等天体）经过（黄道十二宫之一、住宅或星图区域）)
transform	(v., 使改观，使变形，使转化；变换（电流）的电压；（数）变换（数学实体）), (n., （数，语言学）变换式，转换句；（数，语言学）转换规则)
transmit	(v., 播送，传输，发射；传递，传达（思想、情感）；传播，传染（病毒、疾病等）；传导（声、电等），透（光等）)
trigger	(n., （枪械等的）扳机；（尤指引发不良反应或发展的）起因，诱因；（炸弹的）引爆器，触发器), (v., 引发，激发；起动，触发；引爆（炸弹）)
ultimate	(adj., 最终的，最后的；最根本的，最基础的；极限的，终极的；首要的，决定性的；（太空或时空中）最遥远的；（物理）极限的), (n., 最好的事物，最终的事物；最终（或最根本）的事实（或原则）；<美>极限飞盘（Ultimate Frisbee 的简称）), (v., 结束)
transport	(n., 运输，运送；交通工具，运输方式；交通运输系统；（运送部队、给养等的）运输船，运输机；强烈的感情，狂喜；<史>流放犯), (v., （用交通工具）运输，运送；（以自然方式）运输，传播；使产生身临其境的感觉；流放，放逐（犯人）；使狂喜，使（某人）充满强烈情感（尤指快乐）)
undertake	(v., 承担，从事；承诺，答应；<英>在内侧行驶时赶上并超越（另一辆车）)
trend	(n., 趋势，动态；时尚，风尚；热门话题), (v., <美>趋向，倾向；（尤指地理特征的）走向；成为热门话题)
underlie	(vt., 构成……的基础，为……的起因；位于……的下面)
uniform	(n., 制服，校服；<非正式>穿制服的警官；（某一群体的人穿的）典型服装，特有服装；（无线电通讯）字母 U 的代码), (adj., 全部相同的，始终如一的；制服式的), (v., 使一致；使穿制服)
undergo	(v., 经历，经受)
unify	(v., （使）联合，（使）统一；使协调)
unique	(adj., 独一无二的，独特的；非常特别的，极不寻常的；（某人、地或事物）独具的，特有的), (n., <古>独一无二的人（或事）)
utilise	(vt., 使用（等于 utilize）；利用)
via	(prep., 经由，经过（某一地方）；通过，借助于（某种手段或人）)
vary	(v., （使）不同，（使）呈现差异；（根据情况而）变化，改变；改变，使……变化；变奏)
vehicle	(n., 交通工具，车辆；（实现目的的）工具，媒介；（为展露主演者才华而）度身定制的创作（电影、电视节目、歌曲等）；赋形药，调漆料；（个人，组织从事经营、尤指投资的）公司)
version	(n., （同一种物件稍有不同的）样式，型号；（从不同角度的）说法，描述；（电影、剧本、乐曲等的）版本，改编形式；《圣经》译本；胎位倒转术), (v., 创制……的新版本，更新……的版本)
virtual	(adj., 几乎……的，实质上的；（在计算机或互联网上存在或出现的）虚拟的，模拟的；（光学）虚的，虚拟的；（机械学）虚的；（物理）虚的)
violate	(v., 违反，违背；侵犯，打扰；亵渎，损毁（神圣之地等）；<文>强奸)
valid	(adj., （文件或票证）有效的；正当的，合理的；合法有效的；计算机系统接受的，被计算机系统认为有效的)
whereas	(conj., （表示对比）但是，然而；鉴于（用于文件的开头）), (n., 序言，开场白；条件语句)
visible	(adj., 看得见的；明显的，引人注目的；（进出口贸易）有形商品的；（物理）（光）可见的；现有的，可得到的), (n., 有形进出口货物（visibles）)
volume	(n., 体积，容积；总数，总量；音量，响度；（控制音量的）旋钮，控制杆；（成套图书中的）卷，册；（期刊）合订本；书籍；<史>（写在羊皮纸或纸草纸上的）书卷；（尤指头发的）厚，多), (adj., 大量的), (v., 以卷的形式发出；成团卷起)
whereby	(adv., 凭此，借以), (conj., 凭此，借以，与……一致；<非正式>在……的情况下，处于……的位置)
vision	(n., 幻想，想象；幻觉，幻象；构想，展望；眼力，远见卓识；视力，视觉；视野；美好的人（或事物）；（电视或电影的）图像), (v., <罕>想像)
visual	(adj., 视觉的，视力的；栩栩如生的), (n., 视觉资料（指说明性的图片、影片等）)
welfare	(n., 幸福，安康；福利救济，社会福利；（给失业者和穷人的）福利救济金), (adj., 福利的；接受社会救济的)
voluntary	(adj., 自愿的，自发的，主动的；（机构或组织）志愿的，义务性的；（工作）志愿的，无偿的，义务的；（工作者）志愿的，无偿服务的；（人体活动）随意的，可以控制的；<法律>（让与）自愿的，无偿的), (n., （教堂里管风琴演奏的）仪式终始曲；<史>（尤指作为其他作品的序曲，或自由创作的）即兴曲，自由调；（比赛中的）自选表演；自愿行动；志愿者)
widespread	(adj., 普遍的，广泛的)
